26 5
#############      ###
#...........#    ########
#..@........######.......#
#.......................#
#########################

