32 20
#############      ###
#...........#    ########
#...........######.......#
#........................#
#########################

